"filename", "language", "Markdown", "Shell Script", "C++", "MS SQL", "comment", "blank", "total"
"/home/kun/projects/SharePix/CLAUDE.md", "Markdown", 77, 0, 0, 0, 0, 16, 93
"/home/kun/projects/SharePix/backend-service/config/database.sql", "MS SQL", 0, 0, 0, 16, 3, 3, 22
"/home/kun/projects/SharePix/backend-service/deploy-static/build/knot-deploy-20251017-165249/docs/api/README.md", "Markdown", -155, 0, 0, 0, 0, -67, -222
"/home/kun/projects/SharePix/backend-service/deploy-static/build/knot-deploy-20251019-165820/docs/api/README.md", "Markdown", 155, 0, 0, 0, 0, 67, 222
"/home/kun/projects/SharePix/backend-service/project_document/API_DOC_UPDATE.md", "Markdown", -197, 0, 0, 0, 0, -75, -272
"/home/kun/projects/SharePix/backend-service/project_document/README.md", "Markdown", -447, 0, 0, 0, 0, -147, -594
"/home/kun/projects/SharePix/backend-service/project_document/[000]API文档.md", "Markdown", 979, 0, 0, 0, 0, 199, 1178
"/home/kun/projects/SharePix/backend-service/project_document/[004]README.md", "Markdown", 447, 0, 0, 0, 0, 147, 594
"/home/kun/projects/SharePix/backend-service/project_document/[005]API_DOC_UPDATE.md", "Markdown", 197, 0, 0, 0, 0, 75, 272
"/home/kun/projects/SharePix/backend-service/project_document/[105]阶段C-2-多图片帖子系统.md", "Markdown", 39, 0, 0, 0, 0, 10, 49
"/home/kun/projects/SharePix/backend-service/project_document/[107]用户信息更新接口BUG修复报告.md", "Markdown", -383, 0, 0, 0, 0, -112, -495
"/home/kun/projects/SharePix/backend-service/project_document/[108]Feed流性能优化报告.md", "Markdown", -400, 0, 0, 0, 0, -124, -524
"/home/kun/projects/SharePix/backend-service/project_document/[109]阶段D-4-图片静态文件服务实现方案.md", "Markdown", 524, 0, 0, 0, 0, 134, 658
"/home/kun/projects/SharePix/backend-service/project_document/[110]v2.4.0-图片URL自动前缀功能.md", "Markdown", -253, 0, 0, 0, 0, -83, -336
"/home/kun/projects/SharePix/backend-service/project_document/[111]阶段D-4-图片静态文件服务实现方案.md", "Markdown", -524, 0, 0, 0, 0, -134, -658
"/home/kun/projects/SharePix/backend-service/project_document/[112]Base64图片上传问题分析与解决方案.md", "Markdown", -426, 0, 0, 0, 0, -153, -579
"/home/kun/projects/SharePix/backend-service/project_document/[112]JWT测试.md", "Markdown", -644, 0, 0, 0, 0, -158, -802
"/home/kun/projects/SharePix/backend-service/project_document/[112]评论功能实现方案.md", "Markdown", 1548, 0, 0, 0, 0, 352, 1900
"/home/kun/projects/SharePix/backend-service/project_document/[113]全流程测试报告-帖子管理重点.md", "Markdown", -284, 0, 0, 0, 0, -73, -357
"/home/kun/projects/SharePix/backend-service/project_document/[113]日志监控指南-图片上传排查手册.md", "Markdown", -479, 0, 0, 0, 0, -163, -642
"/home/kun/projects/SharePix/backend-service/project_document/[114]多图片功能修复和实现报告.md", "Markdown", -242, 0, 0, 0, 0, -72, -314
"/home/kun/projects/SharePix/backend-service/project_document/[115]创建帖子接口支持JSON+Base64格式-实施计划.md", "Markdown", -686, 0, 0, 0, 0, -202, -888
"/home/kun/projects/SharePix/backend-service/project_document/[116]JSON+Base64内存崩溃紧急修复报告.md", "Markdown", -265, 0, 0, 0, 0, -97, -362
"/home/kun/projects/SharePix/backend-service/project_document/[121]关注功能完整测试报告.md", "Markdown", -57, 0, 0, 0, 0, -16, -73
"/home/kun/projects/SharePix/backend-service/project_document/[122]关注功能测试问题汇总.md", "Markdown", -519, 0, 0, 0, 0, -178, -697
"/home/kun/projects/SharePix/backend-service/project_document/[150]全流程测试报告-帖子管理重点.md", "Markdown", 284, 0, 0, 0, 0, 73, 357
"/home/kun/projects/SharePix/backend-service/project_document/[151]多图片功能修复和实现报告.md", "Markdown", 242, 0, 0, 0, 0, 72, 314
"/home/kun/projects/SharePix/backend-service/project_document/[152]Base64图片上传问题分析与解决方案.md", "Markdown", 426, 0, 0, 0, 0, 153, 579
"/home/kun/projects/SharePix/backend-service/project_document/[153]日志监控指南-图片上传排查手册.md", "Markdown", 479, 0, 0, 0, 0, 163, 642
"/home/kun/projects/SharePix/backend-service/project_document/[154]创建帖子接口支持JSON+Base64格式-实施计划.md", "Markdown", 686, 0, 0, 0, 0, 202, 888
"/home/kun/projects/SharePix/backend-service/project_document/[155]JSON+Base64内存崩溃紧急修复报告.md", "Markdown", 265, 0, 0, 0, 0, 97, 362
"/home/kun/projects/SharePix/backend-service/project_document/[156]创建帖子请求流程文档.md", "Markdown", 330, 0, 0, 0, 0, 102, 432
"/home/kun/projects/SharePix/backend-service/project_document/[157]用户信息更新接口BUG修复报告.md", "Markdown", 383, 0, 0, 0, 0, 112, 495
"/home/kun/projects/SharePix/backend-service/project_document/[158]Feed流性能优化报告.md", "Markdown", 400, 0, 0, 0, 0, 124, 524
"/home/kun/projects/SharePix/backend-service/project_document/[159]JWT测试.md", "Markdown", 644, 0, 0, 0, 0, 158, 802
"/home/kun/projects/SharePix/backend-service/project_document/[160]v2.4.0-图片URL自动前缀功能.md", "Markdown", 253, 0, 0, 0, 0, 83, 336
"/home/kun/projects/SharePix/backend-service/project_document/[161]关注功能测试问题汇总.md", "Markdown", 519, 0, 0, 0, 0, 178, 697
"/home/kun/projects/SharePix/backend-service/project_document/[162]关注功能完整测试报告.md", "Markdown", 57, 0, 0, 0, 0, 16, 73
"/home/kun/projects/SharePix/backend-service/project_document/[163]帖子接口用户ID逻辑化改造方案.md", "Markdown", 738, 0, 0, 0, 0, 236, 974
"/home/kun/projects/SharePix/backend-service/project_document/[164]帖子接口用户ID逻辑化改造-实施报告.md", "Markdown", 299, 0, 0, 0, 0, 105, 404
"/home/kun/projects/SharePix/backend-service/project_document/[165]Feed流用户状态批量查询优化方案.md", "Markdown", 1669, 0, 0, 0, 0, 406, 2075
"/home/kun/projects/SharePix/backend-service/project_document/[166]帖子详情接口添加用户昵称字段-实施方案.md", "Markdown", 660, 0, 0, 0, 0, 178, 838
"/home/kun/projects/SharePix/backend-service/project_document/[167]用户头像上传功能-实施方案.md", "Markdown", 1407, 0, 0, 0, 0, 380, 1787
"/home/kun/projects/SharePix/backend-service/project_document/[168]获取用户帖子接口问题修复方案.md", "Markdown", 936, 0, 0, 0, 4, 321, 1261
"/home/kun/projects/SharePix/backend-service/project_document/[169]头像上传功能内存泄漏问题分析报告.md", "Markdown", 608, 0, 0, 0, 0, 182, 790
"/home/kun/projects/SharePix/backend-service/project_document/[170]收藏列表批量查询优化方案.md", "Markdown", 911, 0, 0, 0, 0, 233, 1144
"/home/kun/projects/SharePix/backend-service/project_document/backup_20251019_144638/API_DOC_UPDATE.md", "Markdown", 197, 0, 0, 0, 0, 75, 272
"/home/kun/projects/SharePix/backend-service/project_document/backup_20251019_144638/README.md", "Markdown", 447, 0, 0, 0, 0, 147, 594
"/home/kun/projects/SharePix/backend-service/project_document/backup_20251019_144638/[000]API文档.md", "Markdown", 2883, 0, 0, 0, 0, 665, 3548
"/home/kun/projects/SharePix/backend-service/project_document/backup_20251019_144638/[001]数据库设计文档.md", "Markdown", 341, 0, 0, 0, 0, 92, 433
"/home/kun/projects/SharePix/backend-service/project_document/backup_20251019_144638/[002]项目架构文档.md", "Markdown", 415, 0, 0, 0, 0, 108, 523
"/home/kun/projects/SharePix/backend-service/project_document/backup_20251019_144638/[003]环境安装配置教程.md", "Markdown", 277, 0, 0, 0, 0, 70, 347
"/home/kun/projects/SharePix/backend-service/project_document/backup_20251019_144638/[100]阶段A-基础模块实现.md", "Markdown", 1226, 0, 0, 0, 0, 279, 1505
"/home/kun/projects/SharePix/backend-service/project_document/backup_20251019_144638/[101]阶段B-用户认证模块.md", "Markdown", 689, 0, 0, 0, 0, 155, 844
"/home/kun/projects/SharePix/backend-service/project_document/backup_20251019_144638/[102]阶段C-图片管理模块.md", "Markdown", 572, 0, 0, 0, 0, 149, 721
"/home/kun/projects/SharePix/backend-service/project_document/backup_20251019_144638/[103]阶段C-1-图片管理模块第一次测试情况.md", "Markdown", 381, 0, 0, 0, 0, 106, 487
"/home/kun/projects/SharePix/backend-service/project_document/backup_20251019_144638/[104]Apifox测试流程-BUG修复验证.md", "Markdown", 388, 0, 0, 0, 0, 96, 484
"/home/kun/projects/SharePix/backend-service/project_document/backup_20251019_144638/[105]阶段C-2-多图片帖子系统.md", "Markdown", 268, 0, 0, 0, 0, 112, 380
"/home/kun/projects/SharePix/backend-service/project_document/backup_20251019_144638/[106]用户信息管理功能完善-实施计划.md", "Markdown", 1205, 0, 0, 0, 0, 302, 1507
"/home/kun/projects/SharePix/backend-service/project_document/backup_20251019_144638/[107]阶段D-1-互动系统点赞收藏功能实现计划.md", "Markdown", 2104, 0, 0, 0, 0, 549, 2653
"/home/kun/projects/SharePix/backend-service/project_document/backup_20251019_144638/[108]阶段D-2-互动系统关注功能实现计划.md", "Markdown", 1461, 0, 0, 0, 0, 369, 1830
"/home/kun/projects/SharePix/backend-service/project_document/backup_20251019_144638/[109]用户信息更新接口BUG修复报告.md", "Markdown", 383, 0, 0, 0, 0, 112, 495
"/home/kun/projects/SharePix/backend-service/project_document/backup_20251019_144638/[110]Feed流性能优化报告.md", "Markdown", 400, 0, 0, 0, 0, 124, 524
"/home/kun/projects/SharePix/backend-service/project_document/backup_20251019_144638/[110]v2.4.0-图片URL自动前缀功能.md", "Markdown", 253, 0, 0, 0, 0, 83, 336
"/home/kun/projects/SharePix/backend-service/project_document/backup_20251019_144638/[110]阶段C-3-帖子图片静态文件服务修复方案.md", "Markdown", 299, 0, 0, 0, 0, 71, 370
"/home/kun/projects/SharePix/backend-service/project_document/backup_20251019_144638/[111]Deep Link配置使用教程-鸿蒙开发指南.md", "Markdown", 1700, 0, 0, 0, 2, 374, 2076
"/home/kun/projects/SharePix/backend-service/project_document/backup_20251019_144638/[111]阶段D-4-图片静态文件服务实现方案.md", "Markdown", 524, 0, 0, 0, 0, 134, 658
"/home/kun/projects/SharePix/backend-service/project_document/backup_20251019_144638/[112]Base64图片上传问题分析与解决方案.md", "Markdown", 426, 0, 0, 0, 0, 153, 579
"/home/kun/projects/SharePix/backend-service/project_document/backup_20251019_144638/[112]JWT测试.md", "Markdown", 644, 0, 0, 0, 0, 158, 802
"/home/kun/projects/SharePix/backend-service/project_document/backup_20251019_144638/[113]全流程测试报告-帖子管理重点.md", "Markdown", 284, 0, 0, 0, 0, 73, 357
"/home/kun/projects/SharePix/backend-service/project_document/backup_20251019_144638/[113]日志监控指南-图片上传排查手册.md", "Markdown", 479, 0, 0, 0, 0, 163, 642
"/home/kun/projects/SharePix/backend-service/project_document/backup_20251019_144638/[114]多图片功能修复和实现报告.md", "Markdown", 242, 0, 0, 0, 0, 72, 314
"/home/kun/projects/SharePix/backend-service/project_document/backup_20251019_144638/[115]创建帖子接口支持JSON+Base64格式-实施计划.md", "Markdown", 686, 0, 0, 0, 0, 202, 888
"/home/kun/projects/SharePix/backend-service/project_document/backup_20251019_144638/[116]JSON+Base64内存崩溃紧急修复报告.md", "Markdown", 265, 0, 0, 0, 0, 97, 362
"/home/kun/projects/SharePix/backend-service/project_document/backup_20251019_144638/[117]帖子接口用户ID逻辑化改造-实施报告.md", "Markdown", 299, 0, 0, 0, 0, 105, 404
"/home/kun/projects/SharePix/backend-service/project_document/backup_20251019_144638/[117]帖子接口用户ID逻辑化改造方案.md", "Markdown", 738, 0, 0, 0, 0, 236, 974
"/home/kun/projects/SharePix/backend-service/project_document/backup_20251019_144638/[118]Feed流用户状态批量查询优化方案.md", "Markdown", 1669, 0, 0, 0, 0, 406, 2075
"/home/kun/projects/SharePix/backend-service/project_document/backup_20251019_144638/[119]帖子详情接口添加用户昵称字段-实施方案.md", "Markdown", 660, 0, 0, 0, 0, 178, 838
"/home/kun/projects/SharePix/backend-service/project_document/backup_20251019_144638/[120]用户头像上传功能-实施方案.md", "Markdown", 1407, 0, 0, 0, 0, 380, 1787
"/home/kun/projects/SharePix/backend-service/project_document/backup_20251019_144638/[121]关注功能完整测试报告.md", "Markdown", 57, 0, 0, 0, 0, 16, 73
"/home/kun/projects/SharePix/backend-service/project_document/backup_20251019_144638/[121]头像上传功能内存泄漏问题分析报告.md", "Markdown", 442, 0, 0, 0, 0, 133, 575
"/home/kun/projects/SharePix/backend-service/project_document/backup_20251019_144638/[122]关注功能测试问题汇总.md", "Markdown", 519, 0, 0, 0, 0, 178, 697
"/home/kun/projects/SharePix/backend-service/project_document/backup_20251019_144638/[123]获取用户帖子接口问题修复方案.md", "Markdown", 936, 0, 0, 0, 4, 321, 1261
"/home/kun/projects/SharePix/backend-service/project_document/backup_20251019_144638/[200]数据库设计文档.md", "Markdown", 353, 0, 0, 0, 0, 120, 473
"/home/kun/projects/SharePix/backend-service/project_document/backup_20251019_144638/[201]性能优化专题.md", "Markdown", 412, 0, 0, 0, 0, 127, 539
"/home/kun/projects/SharePix/backend-service/project_document/backup_20251019_144638/创建帖子请求流程文档.md", "Markdown", 330, 0, 0, 0, 0, 102, 432
"/home/kun/projects/SharePix/backend-service/project_document/backup_20251019_144638/文档重新编号方案.md", "Markdown", 238, 0, 0, 0, 0, 79, 317
"/home/kun/projects/SharePix/backend-service/project_document/rename_docs.sh", "Shell Script", 0, 92, 0, 0, 13, 18, 123
"/home/kun/projects/SharePix/backend-service/project_document/创建帖子请求流程文档.md", "Markdown", -330, 0, 0, 0, 0, -102, -432
"/home/kun/projects/SharePix/backend-service/project_document/文档重新编号方案.md", "Markdown", 238, 0, 0, 0, 0, 79, 317
"/home/kun/projects/SharePix/backend-service/src/api/auth_handler.cpp", "C++", 0, 0, 68, 0, 12, 21, 101
"/home/kun/projects/SharePix/backend-service/src/api/auth_handler.h", "C++", 0, 0, 1, 0, 5, 1, 7
"/home/kun/projects/SharePix/backend-service/src/api/comment_handler.cpp", "C++", 0, 0, 163, 0, 32, 39, 234
"/home/kun/projects/SharePix/backend-service/src/api/comment_handler.h", "C++", 0, 0, 17, 0, 36, 10, 63
"/home/kun/projects/SharePix/backend-service/src/api/favorite_handler.cpp", "C++", 0, 0, 54, 0, 22, 17, 93
"/home/kun/projects/SharePix/backend-service/src/api/favorite_handler.h", "C++", 0, 0, 4, 0, 0, 0, 4
"/home/kun/projects/SharePix/backend-service/src/api/post_handler.cpp", "C++", 0, 0, 176, 0, 49, 44, 269
"/home/kun/projects/SharePix/backend-service/src/api/post_handler.h", "C++", 0, 0, 6, 0, 0, 0, 6
"/home/kun/projects/SharePix/backend-service/src/core/auth_service.cpp", "C++", 0, 0, 46, 0, 8, 17, 71
"/home/kun/projects/SharePix/backend-service/src/core/auth_service.h", "C++", 0, 0, 10, 0, 17, 3, 30
"/home/kun/projects/SharePix/backend-service/src/core/comment_service.cpp", "C++", 0, 0, 370, 0, 56, 85, 511
"/home/kun/projects/SharePix/backend-service/src/core/comment_service.h", "C++", 0, 0, 43, 0, 93, 17, 153
"/home/kun/projects/SharePix/backend-service/src/core/favorite_service.cpp", "C++", 0, 0, 31, 0, 5, 10, 46
"/home/kun/projects/SharePix/backend-service/src/core/favorite_service.h", "C++", 0, 0, 5, 0, 13, 1, 19
"/home/kun/projects/SharePix/backend-service/src/core/like_service.cpp", "C++", 0, 0, 31, 0, 5, 10, 46
"/home/kun/projects/SharePix/backend-service/src/core/like_service.h", "C++", 0, 0, 6, 0, 13, 1, 20
"/home/kun/projects/SharePix/backend-service/src/core/post_service.cpp", "C++", 0, 0, 0, 0, 2, 1, 3
"/home/kun/projects/SharePix/backend-service/src/core/user_service.cpp", "C++", 0, 0, 33, 0, 11, 13, 57
"/home/kun/projects/SharePix/backend-service/src/core/user_service.h", "C++", 0, 0, 16, 0, 29, 8, 53
"/home/kun/projects/SharePix/backend-service/src/database/comment_repository.cpp", "C++", 0, 0, 500, 0, 35, 142, 677
"/home/kun/projects/SharePix/backend-service/src/database/comment_repository.h", "C++", 0, 0, 20, 0, 75, 14, 109
"/home/kun/projects/SharePix/backend-service/src/database/favorite_repository.cpp", "C++", 0, 0, 88, 0, 28, 23, 139
"/home/kun/projects/SharePix/backend-service/src/database/favorite_repository.h", "C++", 0, 0, 6, 0, 12, 1, 19
"/home/kun/projects/SharePix/backend-service/src/database/image_repository.cpp", "C++", 0, 0, 57, 0, 5, 7, 69
"/home/kun/projects/SharePix/backend-service/src/database/like_repository.cpp", "C++", 0, 0, 88, 0, 28, 23, 139
"/home/kun/projects/SharePix/backend-service/src/database/like_repository.h", "C++", 0, 0, 6, 0, 12, 1, 19
"/home/kun/projects/SharePix/backend-service/src/database/post_repository.cpp", "C++", 0, 0, 241, 0, 37, 51, 329
"/home/kun/projects/SharePix/backend-service/src/database/post_repository.h", "C++", 0, 0, 2, 0, 12, 2, 16
"/home/kun/projects/SharePix/backend-service/src/database/user_repository.cpp", "C++", 0, 0, 190, 0, 40, 54, 284
"/home/kun/projects/SharePix/backend-service/src/database/user_repository.h", "C++", 0, 0, 7, 0, 20, 2, 29
"/home/kun/projects/SharePix/backend-service/src/models/comment.cpp", "C++", 0, 0, 72, 0, 11, 20, 103
"/home/kun/projects/SharePix/backend-service/src/models/comment.h", "C++", 0, 0, 32, 0, 42, 12, 86
"/home/kun/projects/SharePix/backend-service/src/models/image.cpp", "C++", 0, 0, 4, 0, 2, 0, 6
"/home/kun/projects/SharePix/backend-service/src/models/image.h", "C++", 0, 0, 3, 0, 0, 0, 3
"/home/kun/projects/SharePix/backend-service/src/models/post.cpp", "C++", 0, 0, 9, 0, 3, 1, 13
"/home/kun/projects/SharePix/backend-service/src/models/post.h", "C++", 0, 0, 9, 0, 0, 0, 9
"/home/kun/projects/SharePix/backend-service/src/server/http_server.cpp", "C++", 0, 0, 10, 0, 1, 1, 12
"/home/kun/projects/SharePix/backend-service/src/server/http_server.h", "C++", 0, 0, 2, 0, 0, 0, 2
"/home/kun/projects/SharePix/backend-service/src/utils/avatar_processor.cpp", "C++", 0, 0, 204, 0, 45, 56, 305
"/home/kun/projects/SharePix/backend-service/src/utils/avatar_processor.h", "C++", 0, 0, 55, 0, 62, 20, 137
"/home/kun/projects/SharePix/backend-service/test/DIAGNOSIS_RESULT.md", "Markdown", 0, 0, 0, 0, 0, 2, 2
"/home/kun/projects/SharePix/backend-service/test/FAVORITE_400_DIAGNOSIS.md", "Markdown", 171, 0, 0, 0, 0, 57, 228
"/home/kun/projects/SharePix/backend-service/test/diagnose_follow_route.md", "Markdown", 0, 0, 0, 0, 0, 2, 2
"/home/kun/projects/SharePix/backend-service/test/test_comment_api.sh", "Shell Script", 0, 124, 0, 0, 14, 36, 174
"/home/kun/projects/SharePix/backend-service/test/test_favorite_400.sh", "Shell Script", 0, 106, 0, 0, 17, 19, 142
"/home/kun/projects/SharePix/backend-service/test/test_favorite_content_type.sh", "Shell Script", 0, 34, 0, 0, 7, 12, 53
"/home/kun/projects/SharePix/backend-service/test/test_favorites_batch_query.sh", "Shell Script", 0, 78, 0, 0, 11, 20, 109
"/home/kun/projects/SharePix/backend-service/test/test_memory_leak.sh", "Shell Script", 0, 22, 0, 0, 3, 6, 31
"/home/kun/projects/SharePix/backend-service/test/test_user_id_logical.sh", "Shell Script", 0, 113, 0, 0, 17, 31, 161
"/home/kun/projects/SharePix/backend-service/test/test_user_posts_fix.sh", "Shell Script", 0, 106, 0, 0, 12, 25, 143
"/home/kun/projects/SharePix/backend-service/test/verify_logical_id.sh", "Shell Script", 0, 39, 0, 0, 6, 5, 50
"Total", "-", 37779, 714, 2685, 16, 991, 11132, 53317